XXXXXXXXXXXXXXXXXXX
X________X________X
X_XX_XXX_X_XXX_XX_X
X_________________X
X_XX_X_XXXXX_X_XX_X
X____X___X___X____X
XXXX_XXX_X_XXX_XXXX
XXXX_X_______X_XXXX
XXXX_X_XXXXX_X_XXXX
XXXX___XXXXX___XXXX
XXXX_X_XXXXX_X_XXXX
XXXX_X_______X_XXXX
XXXX_X_XXXXX_X_XXXX
X________X________X
X_XX_XXX_X_XXX_XX_X
X__X___________X__X
XX_X_X_XXXXX_X_X_XX
X____X___X___X____X
X_XXXXXX_X_XXXXXX_X
X_________________X
XXXXXXXXXXXXXXXXXXX